{:enemy-table
[{:hp 2 :atk 1 :name :enemy1}
{:hp 4 :atk 1 :name :enemy2}]

:enemy-spawn
{:type :probabilities :probabilities [0.8 0.2]}

:tiles
[[1 1 1 1 1 1 1 1 1 1 1 1 1 1 1]
 [1 0 0 0 1 1 0 0 0 1 1 0 0 0 1]
 [4 2 2 0 1 1 0 0 0 1 1 0 5 0 1]
 [1 0 2 2 1 1 0 0 0 1 1 0 0 0 1]
 [1 1 1 2 2 2 2 2 0 1 1 0 0 0 1]
 [1 1 1 1 1 1 0 2 0 1 1 0 0 0 1]
 [1 0 0 0 1 1 0 2 0 1 1 0 0 0 1]
 [1 0 0 0 1 1 0 2 2 2 2 2 2 2 3]
 [1 0 0 0 0 0 0 0 0 1 1 0 0 0 1]
 [1 1 1 1 1 1 1 1 1 1 1 1 1 1 1]]}